clinical cardiologist	cardiologue clinicien
inherited neuromuscular disorders	pathologies musculaires héréditaires	inherited neuromuscular disorders
randomized study	étude randomisée
protective treatment	traitement protecteur
Duchenne patients	patients Duchenne
heart muscle weakness	insuffisance myocardique	insuffisance cardiaque
left ventricular dysfunction	dysfonctionnement ventriculaire gauche	left ventricular dysfunction
perindopril	périndopril	Le périndopril est un inhibiteur de l'enzyme de conversion de l’angiotensine (ECA en français / IEC ou ACE en anglais). Il est prescrit dans le cas d'hypertension
beta blocker	bêta-bloquant
prepared bisoprolol	préparation de bisoprolol
comparator group	groupe de comparaison
phase-3 trial	essai clinique de phase 3
supplementation	supplémentation
myostatin	myostatine
dystrophin	dystrophine
surrogate gene therapy	thérapie génique de substitution
dystroglycan complex	complexe de dystroglycanes
RNA	ARN
splicing	épissage
oligonucleotide drugs	médicaments oligonucléotidiques
spinal muscular atrophy	atrophie musculaire spinale
stereochemistry	stéréochimie
ligand	ligand	En biologie, un ligand (du latin ligandum, liant) est une molécule qui se lie de manière réversible à une macromolécule ciblée, protéine ou acide nucléique, jouant en général un rôle fonctionnel : stabilisation structurale, catalyse, modulation d'une activité enzymatique, transmission d'un signal.
myotonic dystrophy	dystrophie myotonique
neuromuscular diseases	maladies neuromusculaires
limb-girdle muscular dystrophies	dystrophies musculaires des ceintures
diagnostic yield	rendement diagnostique
